19 15 126
###################
#&#*****#***#*#**&#
#*#*###*#*#*#*#*#*#
#*#*#*#***#*#*#*#*#
#***#*#*#*#*#***#*#
#*#*#***#***#*#*#*#
#*#***###*#*#*#*#*#
#*###*#*#@#*#*#*#*#
#*###*#*#*#*#*#*#*#
#*###*****#*****#*#
#*****###*#*###***#
#*###*#*#*#*#*#####
#*#*#***#***#*#*#*#
#&**#*#***#******&#
###################