11 10
###########
#&#***#&**#
#*#*#*#*#*#
#*#*#*#*#*#
#*#*****#*#
#*#*#*#*#*#
#***#***#*#
#*#*#*###*#
#****@***&#
###########