11 10
###########
#&#   #&  #
# # # # # #
# # # # # #
# #     # #
# # # # # #
#   #   # #
# # # ### #
#    @   &#
###########